12:12
0   0  0  17  0 0  0  0  1  0  0  0
0   17 0  1  0  1  17  0  1  37 17 2
0   17 0  1  0  0  1  0  17 0  17 17
0   17 0  17 0  0  1  0  17 0  17 17
0   1  0  0  0  0  17 0  1  0  17 69 
84  1  17 17 1  17 0  0  68 0  84 0 
0   0  0  0  0  0  1  1  17 1  17 17 
0   0  1  0  0  0  0  17 0  0  0  0
17  1  1  17 17 21 0  17 0  0  1  0 
17  0  0  0  0  0  0  17 0  6  17 0 
1   0  1  1  17 17 17 1  0  0  17 101 
1   0  0  0  0  0  0  4  0  0  1  185 
