12:12
2   1  17 0  0  0  0  1 0  17 0   0
8   1  17 17 69 17 0  1 0  17 0   0
0   17 69 0  17 0  4  0 0  0  17  0
0   0  0  0  0  0  1  0 4  0  0   0
0   17 17 17 0  0  0  0 0  17 0   0
1   0  0  4  0  6  1  0 0  0  1   1
17  17 17 0  17 0  0  1 4  1  0   17
121 1  17 0  17 0  0  0 0  0  17  101
0   84 0  6  0  0  17 0 0  0  17  0
0   4  0  1  0  0  17 0 0  17 0   0
0   0  0  1  0  0  17 0 17 0  0   17
17  1  1  17 0  0  17 0 0  0  17  17
