12:12
1  0  0  0  1  17  17  0  0  0  0  17
0  17 0  1  0  100 0   1  0  17 0  1 
17 69 84 6  0  17  84  0  0  1  0  0
0  1  0  17 0  1   0   17 17 1  0  17
17 0  0  17 0  1   0   1  0  6  69 0 
0  17 0  1  0  17  0   1  0  17 1  1 
0  0  0  1  0  0   101 17 0  0  0  0 
4  1  0  17 0  1   0   17 1  1  0  101 
2  17 0  6  1  17  0   84 0  0  1  0
1  17 0  1  0  17  0   1  17 17 1  0 
17 1  0  36 0  100 0   1  0  0  0  21
17 1  1  17 0  1   69  17 0  1  0  137	 
