12:12
73  0  0  0  17  8   4  0  0  0  17 17
17  17 17 0  17  17  0  0  1  0  0  69 
0   0  4  0  0   0   17 0  17 0  1  0 
0   17 1  1  1   17  0  0  1  0  0  0 
0   0  0  0  0   0   0  0  17 0  0  0 
1   1  17 1  17  1   17 1  1  1  4  1 
1   0  6  0  0   0   0  0  0  0  0  0 
1   0  0  1  17  1   1  17 1  1  17  1 
17  0  0  0  0   4   0  0  0  17 0  0 
101 0  1  0  0   4   0  1  0  1  0  0 
1   53 0  0  0   4   0  0  0  0  0  0 
17  0  0  1  69  1   1  1  17 4  1  0 
