12:12
0 0 0 0 0 0 0 0 0 0 0 49
0 17 17 17 17 17 17 17 17 17 17 17
0 0 0 0 0 0 0 0 38 0 0 0
17 17 17 17 17 17 17 17 17 17 17 0
0 0 0 0 0 0 37 0 0 0 0 0 
0 17 17 17 17 17 17 17 17 17 17 17 
0 0 0 0 0 0 32 0 0 0 0 0 
17 17 17 17 17 17 17 17 17 17 17 0
0 0 0 0 69 0 0 96 0 0 0 32 
0 18 0 18 0 96 0 18 0 18 0 0 
18 0 18 0 18 0 18 0 18 0 18 0 
0 18 0 18 0 18 0 18 0 18 0 50