12:12
37 32 0 0 0 0 38 0 0 0 0 0
38 17 17 17 17 17 17 17 17 17 17 0
0 17 0 0 0 0 38 0 0 0 17 0
0 17 0 17 17 17 17 17 17 0 17 0
0 17 0 17 0 0 37 17 17 0 17 0
0 17 38 17 0 0 37 20 17 0 17 0
0 17 0 17 0 17 17 17 17 0 17 0
0 17 0 17 0 0 0 37 0 0 17 0
0 17 0 17 17 17 17 17 17 17 17 0
0 17 0 0 0 0 0 38 0 0 0 0
32 17 17 17 17 17 17 17 17 17 17 17
37 32 0 0 0 0 0 0 0 0 0 49 
