12:12
0 0 0 0 0 0 0 0 0 0 0 49
0 17 17 17 17 0 17 17 17 17 17 0 
0 17 96 0 17 0 17 0 0 96 17 0
96 17 0 0 17 0 17 0 69 0 17 0
0 17 0 0 17 0 17 0 0 0 17 0 
38 17 0 0 17 96 17 0 96 0 17 0 
37 17 0 0 17 0 17 0 0 0 17 0 
0 0 0 0 17 0 17 0 0 0 17 38 
0 0 0 17 17 0 17 0 0 0 17 0 
0 0 0 17 0 0 0 0 96 0 17 17 
32 0 0 17 0 0 0 0 0 0 17 17 
50 17 17 17 17 17 17 17 17 17 17 17 