12:12
0 0 0 0 0 0 0 18 0 0 0 50
0 0 37 37 37 0 0 35 0 0 0 0
0 0 37 69 37 0 0 18 0 18 0 18
0 0 37 37 37 0 0 0 17 0 17 0
0 0 0 0 0 0 0 0 0 0 0 0
0 0 0 0 0 0 0 0 0 0 0 0
0 0 0 0 17 17 17 17 17 17 17 17
0 0 0 0 17 0 0 0 0 0 0 96
17 17 35 17 17 17 17 17 0 17 17 17
96 0 0 0 0 0 0 0 0 0 0 0
17 17 17 17 17 17 17 17 38 17 17 17
49 0 0 0 0 0 0 0 0 0 0 0 
