12:12
0 0 0 0 96 0 0 0 0 0 0 50
18 0 18 0 18 0 18 0 18 0 18 0 
0 17 0 0 0 38 0 0 0 17 0 17 
18 0 18 0 18 0 18 0 18 0 18 0 
0 0 0 38 38 69 0 38 0 0 0 96 
18 0 18 0 18 38 18 0 18 0 18 0 
0 0 0 96 0 38 0 0 0 0 0 0 
18 0 18 0 18 0 18 0 18 0 18 0 
0 0 0 0 0 0 0 0 0 0 0 0 
18 0 18 0 18 0 18 0 18 0 18 0 
0 17 0 0 0 0 0 96 0 0 17 0 
18 0 18 0 18 0 18 0 18 0 18 49
