12:12
0 0 0 0 0 0 0 0 37 32 0 50
0 0 0 0 0 0 0 0 37 32 0 0
0 0 0 96 0 0 18 0 0 32 32 32
0 0 0 0 0 0 0 0 0 32 32 32
0 69 0 0 0 0 18 0 0 0 0 0
0 0 0 0 0 0 0 0 0 0 0 0
0 0 18 0 18 0 0 0 18 0 18 0
0 0 0 0 0 0 0 0 0 0 0 0
0 0 0 0 0 0 18 0 0 0 96 0
0 0 0 0 0 0 0 0 0 0 0 0
0 0 96 0 0 0 18 0 0 0 0 0
0 0 0 0 0 0 0 0 0 0 0 49
