12:12
0 0 0 96 0 0 18 0 0 0 0 0
0 0 0 0 0 0 37 36 0 0 0 0
0 0 0 0 0 0 18 0 0 0 0 0
0 0 0 0 0 0 18 0 0 0 0 0
0 0 0 0 0 0 18 0 0 0 68 0
18 18 18 18 18 18 18 18 18 18 18 0
0 0 0 0 32 0 18 0 0 0 0 0
0 0 0 0 32 0 18 0 0 0 0 0
0 0 0 0 0 0 18 0 0 0 0 0
0 0 0 0 0 0 18 0 0 0 0 0
0 0 0 0 0 0 18 0 0 0 0 96
0 0 0 0 0 0 18 0 0 0 0 50
