12:12
0 0 0 0 0 0 18 0 0 0 0 0  
0 0 0 0 0 0 0 0 0 0 0 0  
0 0 0 0 0 0 18 0 0 0 0 0  
0 0 0 0 0 0 18 0 0 0 0 0  
0 0 0 0 0 0 18 0 0 0 0 0  
18 18 18 18 18 18 18 18 18 18 18 0  
0 0 0 0 32 0 18 0 0 0 0 0  
0 0 0 0 32 0 18 0 0 0 0 0  
0 0 0 0 0 0 18 0 0 0 0 0  
0 0 0 0 0 0 18 0 0 0 0 0  
0 0 0 0 0 0 18 0 0 0 0 0  
0 0 0 0 0 0 18 96 0 0 0 50  
0
 
 
12:12
0 0 0 0 0 0 0 0 0 32 0 50  
0 0 0 0 0 0 0 0 0 0 0 0  
0 0 0 0 0 0 18 0 0 0 32 32  
0 0 0 0 0 0 0 0 0 32 32 32  
0 0 0 0 0 0 18 0 0 0 0 0  
0 0 0 0 0 0 0 0 0 0 0 0  
0 0 18 0 18 0 0 0 18 0 18 0  
0 0 0 0 0 0 0 0 0 0 0 0  
0 0 0 0 0 0 18 0 0 0 0 0  
0 0 0 0 0 0 0 0 0 0 0 0  
0 0 0 0 0 0 18 0 0 0 0 96  
0 0 0 96 0 0 0 0 0 0 0 49  
0
 
 
12:12
0 0 0 0 0 0 0 0 0 0 0 49  
0 17 17 17 17 17 17 17 17 17 17 17  
0 0 0 0 0 0 0 0 0 0 0 0  
17 17 17 17 17 17 17 17 17 17 17 0  
0 0 0 0 0 0 0 0 0 0 0 0  
0 17 17 17 17 17 17 17 17 17 17 17  
0 0 0 0 0 0 0 0 0 0 0 0  
17 17 17 17 17 17 17 17 17 17 17 0  
0 0 0 0 0 0 0 0 0 0 0 0  
0 18 0 18 0 0 0 18 0 18 0 0  
18 0 18 0 18 0 18 0 18 0 18 0  
0 18 0 18 0 18 0 18 0 18 0 50  
0
 
 
12:12
0 0 0 96 0 0 0 0 0 0 0 50  
18 0 18 0 18 38 18 0 18 0 18 0  
0 17 0 0 0 0 0 0 0 17 0 17  
18 0 18 0 18 0 18 0 18 0 18 0  
0 0 0 0 38 0 0 38 0 0 0 0  
18 0 18 0 18 0 18 0 18 0 18 0  
0 0 0 0 0 0 0 0 0 0 0 0  
18 0 18 0 18 0 18 0 18 0 18 0  
0 0 0 0 0 0 0 0 0 0 0 0  
18 0 18 0 18 0 18 0 18 0 18 0  
0 17 0 0 0 0 0 0 0 0 17 0  
18 0 18 0 18 0 18 0 18 0 18 49  
0
 
 
12:12
37 0 0 0 0 0 0 0 0 0 0 49  
0 17 17 17 17 0 17 17 17 17 17 0  
0 17 0 0 17 0 17 0 0 0 17 0  
0 17 0 0 17 0 17 0 0 0 17 0  
0 17 0 0 17 0 17 0 0 0 17 0  
0 17 0 0 17 0 17 0 0 0 17 0  
0 17 0 0 17 0 17 0 0 0 17 0  
0 0 0 0 17 0 17 0 0 0 17 38  
0 0 0 17 17 0 17 0 0 0 17 0  
0 0 0 17 0 0 0 0 0 0 17 17  
0 0 0 17 0 0 0 0 0 0 17 17  
50 17 17 17 17 17 17 17 17 17 17 17  
0
 
 
12:12
0 0 0 0 0 0 0 18 0 0 0 50  
0 0 37 37 37 0 0 35 0 0 0 0  
0 0 37 69 37 0 0 18 0 18 0 18  
0 0 37 37 37 0 0 0 17 0 17 0  
0 0 0 0 0 0 0 0 0 0 0 0  
0 0 0 0 0 0 0 0 0 0 0 0  
0 0 0 0 17 17 17 17 17 17 17 17  
0 0 0 0 17 0 0 0 0 96 0 0  
17 17 35 17 17 17 17 17 0 17 17 17  
0 96 0 0 0 0 0 0 0 0 0 0  
17 17 17 17 17 17 17 17 38 17 17 17  
49 0 0 0 0 0 0 0 0 0 0 0  
1
 
 
12:12
18 18 18 18 18 18 18 18 18 18 18 49  
18 18 18 18 18 18 18 18 18 18 0 0  
18 18 18 18 18 18 18 18 18 0 0 18  
18 18 18 18 18 18 18 18 96 0 18 18  
18 17 1 1 1 0 0 17 0 0 0 68  
18 0 4 0 6 1 0 0 0 1 1 0  
18 17 17 0 32 1 0 6 4 1 0 17  
18 1 0 0 32 0 0 0 1 17 17 0  
18 4 0 6 1 0 37 0 1 0 0 0  
18 4 0 0 1 0 0 0 1 0 0 0  
18 0 0 1 1 4 4 84 17 0 1 0  
18 96 1 17 1 0 0 0 0 0 0 49  
1
 
 
12:12
18 50 17 0 1 3 1 17 0 0 4 0  
18 0 17 17 17 0 17 1 0 0 17 0  
18 0 1 1 0 0 17 0 0 0 17 0  
18 0 0 0 0 1 0 0 1 1 0 0  
18 17 1 1 1 0 0 17 0 0 0 68  
18 0 4 0 6 1 0 0 0 1 1 0  
18 17 17 0 32 1 0 6 4 1 0 17  
18 1 0 0 32 0 0 0 1 17 17 0  
18 4 0 6 1 0 37 0 1 0 0 0  
18 4 0 0 1 0 0 0 1 0 0 0  
18 0 0 1 1 4 4 84 17 0 1 0  
18 96 1 17 1 0 0 0 0 0 0 49  
1
 
 

 
1
 
 

1
 
 
 
1
 
 
96 96 96 96 96 96 96  
96 96 96 96 96 96 96 96 96 96 96 96  
96 96 96 96 96 96 96 96 96 96 96 96  
96 96 96 96 96 96 96 96 96 96 96 96  
96 96 96 96 96 96 96 96 96 96 96 96  
96 96 96 96 96 96 96 96 96 96 96 96  
96 96 96 96 96 96 96 96 96 96 96 96  
96 96 96 96 96 96 96 96 96 96 96 96  
1
 
 
