12:12
2  0  0  37 0  0  1   0  0  17 69 17
1  17 4  1  0  17 0   1  0  17 0  1 
69 0  0  0  0  0  0   0  0  0  0  0
17 1  0  17 0  1  69  17 0  1  4  17
0  0  0  0  0  0  0   36 0  0  0  0 
0  17 0  1  0  17 0   1  0  17 0  1 
1  0  0  4  0  0  101 0  6  0  0  0 
0  1  20 17 0  1  0   17 0  1  20 17 
1  0  0  6  0  0  4   0  0  0  0  0 
0  17 53 1  0  17 0   1  0  17 0  1 
0  0  0  0  0  84 0   0  6  52  0  101 
17 1  0  17 0  1  0   17 0  1  0  217 
