12:12
2   1  17 69 0  1  69 1 0  17 0   105
4   1  17 17 0  17 0  1 0  17 0   0
0   17 0  0  17 0  4  0 6  0  17  0
0   0  0  0  0  0  1  0 0  0  0   0
0   17 17 17 0  0  0  0 0  17 0   0
1   0  0  4  0  0  1  0 0  69 1   1
17  17 17 0  17 6  0  1 4  1  0   17
8   1  17 0  17 0  0  0 0  0  17  101
0   4  0  6  0  0  17 0 0  0  17  0
0   4  0  1  0  0  17 0 0  17 0   0
0   0  0  1  0  0  17 0 17 0  0   17
17  1  1  17 0  0  17 0 0  0  17  17
