12:12
2   0   17 17 101 0  0   0   0  0  37 0
0   0   1  17 17  69 36  17  1  17 17 41
0   0   84 0  1   17 0   17  1  0  17 17
17  52  4  0  0   1  0   0   0  0  17 1
0   0   17 0  20  17 1   1   84 4 17 17
0   0   0  0  1   69 0   0   0  0  17 1
17  1   17 0  17  17 0   1   84 0  17 17
0   0   0 36  1   17 0   1   0  0  1  17
0   0   1  0  1   0  0   0   0  6  17 8
17  0   36 17 17  17 1   101 1  1  17 0
0   0   4  0  0   0  0   0   0 69  1  20
101 0   17 17 53  17 0   0   0  0  0  0
