12:12
101 1  17 0  1  3  1  17 0  0  4  101
0   1  17 17 17 0  17 1  0  0  17   0
0   17 1  1  0  0  17 0  0  69 17   0
0   0  0  0  0  1  0  0  1  1  0    0
0   17 1  1  1  0  0  17 0  0  0    68
0   0  0  4  0  6  1  0  0  0  1    1
17  17 17 0  17 1  0  6  4  1  0   17
101 1  0  0  17 0  0  0  1  17  17 101
63  4  0  6  1  0  0  69 1  0  0   0
0   4  0  0  1  0  0  0  1  0  1   0
0   0  0  1  1  4  4  84 17 0  1   0
17  1  1  17 1  0  0  0  0  0  17  2
